1111111111111111111111
1C100000P00000000001E1
1010000000000000000001
1010000000000000000101
1010000000C00000000101
1011111111111000000111
1010000000000000C00001
1010000000C00000000001
1010000000000000000001
1010000000000000C00001
10100000C0000000000001
1010000000000000000001
10100000C0000000000001
10100000000000000C0001
10C0000000000000000001
1111111111111111111111