1111111111111111111111
10100000100000000001E1
1010110000011110000001
1010000100000010111101
1010000111100010000101
1111111111111111111111