111111111111111111111
101000001000000000011
10101100P0011110E0001
1010000100C0001011111
101000011110001000011
111111111111111111111