1111111111111
1001000C00C1
1000011111001
1P00110C0E001
1111111111111