1111111111111111111111
1010C001000C00000C1E11
1010110000C11110000001
1C10000100000010111101
1010C0011110001000C101
1011111000C01011100111
1010000C11010000000C01
1010111101010C11110001
10C0000011010000011101
10100111000C1011110001
1010C00011010000000001
1010111100010111110001
1010000001010000C00001
10100000000C1001111101
11000C0000000000000011
P111111111111111111111
