1111111111111111111111
1010C0001000C00000C1E1
1010110000C1111000000101
10000C000000000000001
1111111111111111111111
